{
  "characters": {
    "pacman": [13.5, 1],
    "inky": [11.5,26],
    "pinky": [13.5,26],
    "clyde": [15.5,26],
    "blinky": [13.5,23]
  },
  "static_objects": {
    "fruit": [13.5,13],
    "big_dots": [[3,3],	[1,29],	[24,3],	[26,29]]
  },
  "rects": {
    "no_dots": [[8,23,18,29]],
    "slow_zone": []
  },
  "map":[
    [1,22,21,6,6,6,6,6,6,6,6,6,6,6,6,6,6,6,6,6,6,6,6,6,6,22,21,2],
    [18,12,15,32,32,32,32,32,32,32,32,32,32,32,32,32,32,32,32,32,32,32,32,32,32,13,11,20],
    [17,16,12,32,9,14,14,14,14,10,32,9,14,14,14,14,10,32,9,14,14,14,14,10,32,11,16,19],
    [5,32,32,32,13,9,16,16,16,12,32,11,16,16,16,16,12,32,11,16,16,16,10,15,32,32,32,7],
    [5,32,9,14,12,15,32,32,32,32,32,32,32,32,32,32,32,32,32,32,32,32,15,11,14,10,32,7],
    [5,32,11,16,16,12,32,9,14,14,14,14,14,14,14,14,14,14,14,14,10,32,11,16,16,12,32,7],
    [5,32,32,32,32,32,32,11,16,16,16,16,10,32,32,9,16,16,16,16,12,32,32,32,32,32,32,7],
    [18,14,14,14,14,10,32,32,32,32,32,32,13,32,32,15,32,32,32,32,32,32,9,14,14,14,14,20],
    [17,16,16,16,16,12,32,9,14,14,10,32,13,32,32,15,32,9,14,14,10,32,11,16,16,16,16,19],
    [5,32,32,32,32,32,32,11,16,16,12,32,13,32,32,15,32,11,16,16,12,32,32,32,32,32,32,7],
    [5,32,9,14,14,10,32,32,32,32,32,32,13,32,32,15,32,32,32,32,32,32,9,14,14,10,32,7],
    [5,32,13,32,32,15,32,9,14,14,14,14,12,32,32,11,14,14,14,14,10,32,13,32,32,15,32,7],
    [5,32,13,32,32,15,32,11,16,16,16,16,16,16,16,16,16,16,16,16,12,32,13,32,32,15,32,7],
    [5,32,11,16,16,12,32,32,32,32,32,32,32,32,32,32,32,32,32,32,32,32,11,16,16,12,32,7],
    [5,32,32,32,32,32,32,9,14,14,10,32,9,14,14,10,32,9,14,14,10,32,32,32,32,32,32,7],
    [5,32,9,14,14,10,32,13,32,32,15,32,13,32,32,15,32,13,32,32,15,32,9,14,14,10,32,7],
    [5,32,13,32,32,15,32,13,32,32,15,32,11,16,16,12,32,13,32,32,15,32,13,32,32,15,32,7],
    [5,32,13,32,32,15,32,13,32,32,15,32,32,32,32,32,32,13,32,32,15,32,13,32,32,15,32,7],
    [5,32,13,32,32,15,32,11,16,16,12,32,9,14,14,10,32,11,16,16,12,32,13,32,32,15,32,7],
    [5,32,13,32,32,15,32,32,32,32,32,32,13,32,32,15,32,32,32,32,32,32,13,32,32,15,32,7],
    [5,32,13,32,32,11,14,14,14,14,10,32,13,32,32,15,32,9,14,14,14,14,12,32,32,15,32,7],
    [5,32,13,32,32,32,32,32,32,32,15,32,13,32,32,15,32,13,32,32,32,32,32,32,32,15,32,7],
    [5,32,11,16,16,16,16,16,16,16,12,32,11,16,16,12,32,11,16,16,16,16,16,16,16,12,32,7],
    [5,32,32,32,32,32,32,32,32,32,32,32,32,32,32,32,32,32,32,32,32,32,32,32,32,32,32,7],
    [5,32,9,14,10,32,9,14,10,32,27,8,25,31,31,26,8,28,32,9,14,10,32,9,14,10,32,7],
    [5,32,13,32,15,32,13,32,15,32,7,32,32,32,32,32,32,5,32,13,32,15,32,13,32,15,32,7],
    [5,32,13,32,15,32,13,32,15,32,7,32,32,32,32,32,32,5,32,13,32,15,32,13,32,15,32,7],
    [5,32,13,32,15,32,13,32,15,32,7,32,32,32,32,32,32,5,32,13,32,15,32,13,32,15,32,7],
    [5,32,11,16,12,32,11,16,12,32,29,6,6,6,6,6,6,30,32,11,16,12,32,11,16,12,32,7],
    [5,32,32,32,32,32,32,32,32,32,32,32,32,32,32,32,32,32,32,32,32,32,32,32,32,32,32,7],
    [3,8,8,8,8,8,8,8,8,8,8,8,8,8,8,8,8,8,8,8,8,8,8,8,8,8,8,4]
  ],
  "collision_map": [
    [0,	0,	0,	0,	0,	0,	0,	0,	0,	0,	0,	0,	0,	0,	0,	0,	0,	0,	0,	0,	0,	0,	0,	0,	0,	0,	0,	0],
    [0,	0,	0,	3,	5,	5,	5,	5,	5,	5,	7,	5,	5,	5,	5,	5,	5,	7,	5,	5,	5,	5,	5,	5,	6,	0,	0,	0],
    [0,	0,	0,	10,	0,	0,	0,	0,	0,	0,	10,	0,	0,	0,	0,	0,	0,	10,	0,	0,	0,	0,	0,	0,	10,	0,	0,	0],
    [0,	3,	5,	12,	0,	0,	0,	0,	0,	0,	10,	0,	0,	0,	0,	0,	0,	10,	0,	0,	0,	0,	0,	0,	9,	5,	6,	0],
    [0,	10,	0,	0,	0,	0,	3,	5,	5,	5,	13,	5,	5,	5,	5,	5,	5,	13,	5,	5,	5,	6,	0,	0,	0,	0,	10,	0],
    [0,	10,	0,	0,	0,	0,	10,	0,	0,	0,	0,	0,	0,	0,	0,	0,	0,	0,	0,	0,	0,	10,	0,	0,	0,	0,	10,	0],
    [0,	9,	5,	5,	5,	5,	14,	0,	0,	0,	0,	0,	0,	0,	0,	0,	0,	0,	0,	0,	0,	11,	5,	5,	5,	5,	12,	0],
    [0,	0,	0,	0,	0,	0,	11,	5,	5,	5,	5,	6,	0,	0,	0,	0,	3,	5,	5,	5,	5,	14,	0,	0,	0,	0,	0,	0],
    [0,	0,	0,	0,	0,	0,	10,	0,	0,	0,	0,	10,	0,	0,	0,	0,	10,	0,	0,	0,	0,	10,	0,	0,	0,	0,	0,	0],
    [0,	3,	5,	5,	5,	5,	14,	0,	0,	0,	0,	10,	0,	0,	0,	0,	10,	0,	0,	0,	0,	11,	5,	5,	5,	5,	6,	0],
    [0,	10,	0,	0,	0,	0,	11,	5,	5,	5,	5,	12,	0,	0,	0,	0,	9,	5,	5,	5,	5,	14,	0,	0,	0,	0,	10,	0],
    [0,	10,	0,	0,	0,	0,	10,	0,	0,	0,	0,	0,	0,	0,	0,	0,	0,	0,	0,	0,	0,	10,	0,	0,	0,	0,	10,	0],
    [0,	10,	0,	0,	0,	0,	10,	0,	0,	0,	0,	0,	0,	0,	0,	0,	0,	0,	0,	0,	0,	10,	0,	0,	0,	0,	10,	0],
    [0,	10,	0,	0,	0,	0,	11,	5,	5,	5,	5,	7,	5,	5,	5,	5,	7,	5,	5,	5,	5,	14,	0,	0,	0,	0,	10,	0],
    [0,	11,	5,	5,	5,	5,	14,	0,	0,	0,	0,	10,	0,	0,	0,	0,	10,	0,	0,	0,	0,	11,	5,	5,	5,	5,	14,	0],
    [0,	10,	0,	0,	0,	0,	10,	0,	0,	0,	0,	10,	0,	0,	0,	0,	10,	0,	0,	0,	0,	10,	0,	0,	0,	0,	10,	0],
    [0,	10,	0,	0,	0,	0,	10,	0,	0,	0,	0,	10,	0,	0,	0,	0,	10,	0,	0,	0,	0,	10,	0,	0,	0,	0,	10,	0],
    [0,	10,	0,	0,	0,	0,	10,	0,	0,	0,	0,	11,	5,	5,	5,	5,	14,	0,	0,	0,	0,	10,	0,	0,	0,	0,	10,	0],
    [0,	10,	0,	0,	0,	0,	10,	0,	0,	0,	0,	10,	0,	0,	0,	0,	10,	0,	0,	0,	0,	10,	0,	0,	0,	0,	10,	0],
    [0,	10,	0,	0,	0,	0,	9,	5,	5,	5,	5,	14,	0,	0,	0,	0,	11,	5,	5,	5,	5,	12,	0,	0,	0,	0,	10,	0],
    [0,	10,	0,	0,	0,	0,	0,	0,	0,	0,	0,	10,	0,	0,	0,	0,	10,	0,	0,	0,	0,	0,	0,	0,	0,	0,	10,	0],
    [0,	10,	0,	0,	0,	0,	0,	0,	0,	0,	0,	10,	0,	0,	0,	0,	10,	0,	0,	0,	0,	0,	0,	0,	0,	0,	10,	0],
    [0,	10,	0,	0,	0,	0,	0,	0,	0,	0,	0,	10,	0,	0,	0,	0,	10,	0,	0,	0,	0,	0,	0,	0,	0,	0,	10,	0],
    [0,	11,	5,	5,	5,	7,	5,	5,	5,	7,	5,	13,	5,	5,	5,	5,	13,	5,	7,	5,	5,	5,	7,	5,	5,	5,	14,	0],
    [0,	10,	0,	0,	0,	10,	0,	0,	0,	10,	0,	0,	0,	0,	0,	0,	0,	0,	10,	0,	0,	0,	10,	0,	0,	0,	10,	0],
    [0,	10,	0,	0,	0,	10,	0,	0,	0,	10,	0,	0,	0,	0,	0,	0,	0,	0,	10,	0,	0,	0,	10,	0,	0,	0,	10,	0],
    [0,	10,	0,	0,	0,	10,	0,	0,	0,	10,	0,	0,	0,	0,	0,	0,	0,	0,	10,	0,	0,	0,	10,	0,	0,	0,	10,	0],
    [0,	10,	0,	0,	0,	10,	0,	0,	0,	10,	0,	0,	0,	0,	0,	0,	0,	0,	10,	0,	0,	0,	10,	0,	0,	0,	10,	0],
    [0,	10,	0,	0,	0,	10,	0,	0,	0,	10,	0,	0,	0,	0,	0,	0,	0,	0,	10,	0,	0,	0,	10,	0,	0,	0,	10,	0],
    [0,	9,	5,	5,	5,	13,	5,	5,	5,	13,	5,	5,	5,	5,	5,	5,	5,	5,	13,	5,	5,	5,	13,	5,	5,	5,	12,	0],
    [0,	0,	0,	0,	0,	0,	0,	0,	0,	0,	0,	0,	0,	0,	0,	0,	0,	0,	0,	0,	0,	0,	0,	0,	0,	0,	0,	0]
  ]
}
