{
  "characters": {
    "pacman": [13.5, 17],
    "inky": [11.5,26],
    "pinky": [13.5,26],
    "clyde": [15.5,26],
    "blinky": [13.5,23]
  },
  "static_objects": {
    "fruit": [13.5, 11],
    "big_dots": [[1,1],[1,23],[26,1],[26,23]]
  },
  "rects": {
    "no_dots": [[7,21,20,30],[0,29,6,29],[21,29,27,29]],
    "slow_zone": [[0,29,3,29],[24,29,27,29]]
  },
 "map":[
    [1,6,6,6,6,6,6,6,6,6,6,6,6,6,6,6,6,6,6,6,6,6,6,6,6,6,6,2],
    [5,32,32,32,32,32,32,32,32,32,32,32,32,32,32,32,32,32,32,32,32,32,32,32,32,32,32,7],
    [5,32,9,14,14,10,32,9,14,14,10,32,9,14,14,10,32,9,14,14,14,14,14,14,14,10,32,7],
    [5,32,13,32,32,15,32,13,32,32,15,32,13,32,32,15,32,13,32,32,32,32,32,32,32,15,32,7],
    [5,32,13,32,32,15,32,13,32,32,15,32,13,32,32,15,32,13,32,32,32,32,32,32,32,15,32,7],
    [5,32,11,6,6,12,32,11,6,6,12,32,11,6,6,12,32,11,6,6,6,6,6,6,6,12,32,7],
    [5,32,32,32,32,32,32,32,32,32,32,32,32,32,32,32,32,32,32,32,32,32,32,32,32,32,32,7],
    [5,32,9,14,14,14,14,14,14,14,14,14,14,14,14,10,32,9,14,14,10,32,9,14,14,10,32,7],
    [5,32,13,32,32,32,32,32,32,32,32,32,32,32,32,15,32,13,32,32,15,32,13,32,32,15,32,7],
    [5,32,13,32,32,32,32,32,32,32,32,32,32,32,32,15,32,13,32,32,15,32,13,32,32,15,32,7],
    [5,32,11,6,6,6,6,6,6,6,6,6,6,6,6,12,32,11,6,6,12,32,11,6,6,12,32,7],
    [5,32,32,32,32,32,32,32,32,32,32,32,32,32,32,32,32,32,32,32,32,32,32,32,32,32,32,7],
    [18,14,14,10,32,9,14,14,14,14,14,14,14,14,14,14,14,14,14,14,14,14,10,32,9,14,14,20],
    [17,16,16,12,32,11,16,16,16,16,16,16,16,10,9,16,16,16,16,16,16,16,12,32,11,16,16,19],
    [5,32,32,32,32,32,32,32,32,32,32,32,32,13,15,32,32,32,32,32,32,32,32,32,32,32,32,7],
    [5,32,9,14,14,10,32,9,14,14,14,10,32,13,15,32,9,14,14,14,10,32,9,14,14,10,32,7],
    [5,32,11,16,16,12,32,11,16,16,10,15,32,11,12,32,13,9,16,16,12,32,11,16,16,12,32,7],
    [5,32,32,32,32,32,32,32,32,32,13,15,32,32,32,32,13,15,32,32,32,32,32,32,32,32,32,7],
    [18,14,14,10,32,9,14,14,10,32,13,15,32,9,10,32,13,15,32,9,14,14,10,32,9,14,14,20],
    [17,16,16,12,32,11,16,10,15,32,11,12,32,13,15,32,11,12,32,13,9,16,12,32,11,16,16,19],
    [5,32,32,32,32,32,32,13,15,32,32,32,32,13,15,32,32,32,32,13,15,32,32,32,32,32,32,7],
    [5,32,9,14,14,10,32,13,15,32,9,14,14,12,11,14,14,10,32,13,15,32,9,14,14,10,32,7],
    [5,32,11,16,10,15,32,11,12,32,11,16,16,16,16,16,16,12,32,11,12,32,13,9,16,12,32,7],
    [5,32,32,32,13,15,32,32,32,32,32,32,32,32,32,32,32,32,32,32,32,32,13,15,32,32,32,7],
    [3,8,10,32,13,15,32,9,10,32,27,8,25,31,31,26,8,28,32,9,10,32,13,15,32,9,8,4],
    [32,32,5,32,11,12,32,13,15,32,7,32,32,32,32,32,32,5,32,13,15,32,11,12,32,7,32,32],
    [32,32,5,32,32,32,32,13,15,32,7,32,32,32,32,32,32,5,32,13,15,32,32,32,32,7,32,32],
    [32,32,5,32,9,14,14,12,15,32,7,32,32,32,32,32,32,5,32,13,11,14,14,10,32,7,32,32],
    [6,6,12,32,11,16,16,16,12,32,29,6,6,6,6,6,6,30,32,11,16,16,16,12,32,11,6,6],
    [32,32,32,32,32,32,32,32,32,32,32,32,32,32,32,32,32,32,32,32,32,32,32,32,32,32,32,32],
    [8,8,8,8,8,8,8,8,8,8,8,8,8,8,8,8,8,8,8,8,8,8,8,8,8,8,8,8]
  ],
  "collision_map": [
    [0,	0,	0,	0,	0,	0,	0,	0,	0,	0,	0,	0,	0,	0,	0,	0,	0,	0,	0,	0,	0,	0,	0,	0,	0,	0,	0,	0],
    [0,	3,	5,	5,	5,	5,	7,	5,	5,	5,	5,	7,	5,	5,	5,	5,	7,	5,	5,	5,	5,	5,	5,	5,	5,	5,	6,	0],
    [0,	10,	0,	0,	0,	0,	10,	0,	0,	0,	0,	10,	0,	0,	0,	0,	10,	0,	0,	0,	0,	0,	0,	0,	0,	0,	10,	0],
    [0,	10,	0,	0,	0,	0,	10,	0,	0,	0,	0,	10,	0,	0,	0,	0,	10,	0,	0,	0,	0,	0,	0,	0,	0,	0,	10,	0],
    [0,	10,	0,	0,	0,	0,	10,	0,	0,	0,	0,	10,	0,	0,	0,	0,	10,	0,	0,	0,	0,	0,	0,	0,	0,	0,	10,	0],
    [0,	10,	0,	0,	0,	0,	10,	0,	0,	0,	0,	10,	0,	0,	0,	0,	10,	0,	0,	0,	0,	0,	0,	0,	0,	0,	10,	0],
    [0,	11,	5,	5,	5,	5,	13,	5,	5,	5,	5,	13,	5,	5,	5,	5,	15,	5,	5,	5,	5,	7,	5,	5,	5,	5,	14,	0],
    [0,	10,	0,	0,	0,	0,	0,	0,	0,	0,	0,	0,	0,	0,	0,	0,	10,	0,	0,	0,	0,	10,	0,	0,	0,	0,	10,	0],
    [0,	10,	0,	0,	0,	0,	0,	0,	0,	0,	0,	0,	0,	0,	0,	0,	10,	0,	0,	0,	0,	10,	0,	0,	0,	0,	10,	0],
    [0,	10,	0,	0,	0,	0,	0,	0,	0,	0,	0,	0,	0,	0,	0,	0,	10,	0,	0,	0,	0,	10,	0,	0,	0,	0,	10,	0],
    [0,	10,	0,	0,	0,	0,	0,	0,	0,	0,	0,	0,	0,	0,	0,	0,	10,	0,	0,	0,	0,	10,	0,	0,	0,	0,	10,	0],
    [0,	9,	5,	5,	7,	5,	5,	5,	5,	5,	5,	5,	5,	5,	5,	5,	13,	5,	5,	5,	5,	13,	5,	7,	5,	5,	12,	0],
    [0,	0,	0,	0,	10,	0,	0,	0,	0,	0,	0,	0,	0,	0,	0,	0,	0,	0,	0,	0,	0,	0,	0,	10,	0,	0,	0,	0],
    [0,	0,	0,	0,	10,	0,	0,	0,	0,	0,	0,	0,	0,	0,	0,	0,	0,	0,	0,	0,	0,	0,	0,	10,	0,	0,	0,	0],
    [0,	3,	5,	5,	13,	5,	7,	5,	5,	5,	5,	5,	6,	0,	0,	3,	5,	5,	5,	5,	5,	7,	5,	13,	5,	5,	6,	0],
    [0,	10,	0,	0,	0,	0,	10,	0,	0,	0,	0,	0,	10,	0,	0,	10,	0,	0,	0,	0,	0,	10,	0,	0,	0,	0,	10,	0],
    [0,	10,	0,	0,	0,	0,	10,	0,	0,	0,	0,	0,	10,	0,	0,	10,	0,	0,	0,	0,	0,	10,	0,	0,	0,	0,	10,	0],
    [0,	9,	5,	5,	7,	5,	13,	5,	5,	6,	0,	0,	11,	5,	5,	14,	0,	0,	3,	5,	5,	13,	5,	7,	5,	5,	12,	0],
    [0,	0,	0,	0,	10,	0,	0,	0,	0,	10,	0,	0,	10,	0,	0,	10,	0,	0,	10,	0,	0,	0,	0,	10,	0,	0,	0,	0],
    [0,	0,	0,	0,	10,	0,	0,	0,	0,	10,	0,	0,	10,	0,	0,	10,	0,	0,	10,	0,	0,	0,	0,	10,	0,	0,	0,	0],
    [0,	3,	5,	5,	13,	5,	6,	0,	0,	11,	5,	5,	12,	0,	0,	9,	5,	5,	14,	0,	0,	3,	5,	13,	5,	5,	6,	0],
    [0,	10,	0,	0,	0,	0,	10,	0,	0,	10,	0,	0,	0,	0,	0,	0,	0,	0,	10,	0,	0,	10,	0,	0,	0,	0,	10,	0],
    [0,	10,	0,	0,	0,	0,	10,	0,	0,	10,	0,	0,	0,	0,	0,	0,	0,	0,	10,	0,	0,	10,	0,	0,	0,	0,	10,	0],
    [0,	9,	5,	6,	0,	0,	11,	5,	5,	15,	5,	5,	5,	5,	5,	5,	5,	5,	15,	5,	5,	14,	0,	0,	3,	5,	12,	0],
    [0,	0,	0,	10,	0,	0,	10,	0,	0,	10,	0,	0,	0,	0,	0,	0,	0,	0,	10,	0,	0,	10,	0,	0,	10,	0,	0,	0],
    [0,	0,	0,	10,	0,	0,	10,	0,	0,	10,	0,	0,	0,	0,	0,	0,	0,	0,	10,	0,	0,	10,	0,	0,	10,	0,	0,	0],
    [0,	0,	0,	11,	5,	5,	12,	0,	0,	10,	0,	0,	0,	0,	0,	0,	0,	0,	10,	0,	0,	9,	5,	5,	14,	0,	0,	0],
    [0,	0,	0,	10,	0,	0,	0,	0,	0,	10,	0,	0,	0,	0,	0,	0,	0,	0,	10,	0,	0,	0,	0,	0,	10,	0,	0,	0],
    [0,	0,	0,	10,	0,	0,	0,	0,	0,	10,	0,	0,	0,	0,	0,	0,	0,	0,	10,	0,	0,	0,	0,	0,	10,	0,	0,	0],
    [5,	5,	5,	13,	5,	5,	5,	5,	5,	13,	5,	5,	5,	5,	5,	5,	5,	5,	13,	5,	5,	5,	5,	5,	13,	5,	5,	5],
    [0,	0,	0,	0,	0,	0,	0,	0,	0,	0,	0,	0,	0,	0,	0,	0,	0,	0,	0,	0,	0,	0,	0,	0,	0,	0,	0,	0]
  ]
}
